xxxxxxxxxxxxxx
xxx-----x-o--x
xx---o---xxxxx
x------------x
x---xxoxx----x
x-----x------x
x----o-------x
xo----------ox
xxx-------o--x
xxxxxxxxxxxxxx