xxxxxxxxxxxxxx
xxx--------o-x
x-o----------x
x----o----o--x
x------------x
x------------x
x-o-xxxx-----x
x------------x
x-------o----x
xxxxxxxxxxxxxx